
  000000000
  000001000
  00RHRHR00
  06H0H0H20
  00RHRHR00
  05H0H0H00
  00RHRHR00
  000403000
  000000000
