
  000000000
  000001000
  00R.R.R00
  06.0.0.20
  00R.R.R00
  05.0.0.00
  00R.R.R00
  000403000
  000000000
