
  000000000
  00000S000
  001H2H300
  0PH0H0HM0
  004H5H600
  0BH0H0H00
  007H8H900
  000G0W000
  000000000
